25 10
#########################
#           #           #
#           #           #
#           #           #
#           #           #
#           #           #
#           #           #
#           |           #
#  P  b     |         E #
#########################
