20 20
####################
#..................#
#..................#
#G.................#
################...#
#..................#
#..................#
#..................#
#..................#
#..................#
#.......###........#
#..................#
#..................#
#..................#
#..................#
#..................#
#..#################
#..................#
#..................#
####################