25 10
#########################
#.......................#
#.......................#
#.......................#
#.......................#
#.......................#
#...........S...........#
#........S.....S........#
#..P..############....E.#
#########################
