50 5
##################################################
#................................................#
#................................................#
#................................................#
#..P..y..SSSSSSSSSSSSSSSSSSSSSSSSSSSSSSSSSSS..E..#
##################################################
