################################################
#                                              #
#                                              #
#                                              #
#                                              #
#                                              #
#                                              #
#                                              #
#                                              #
#                                              #
#g P                                        E  #
######                                    ######
#######                                   ######
########                                  ######
#########                                 ######
##########                                ######
###########                               ######
############                              ######
#############                             ######
##############                            ######
###############                           ######
################                          ######
################################################