25 10
#########################
#.......................#
#.......................#
#.......................#
#.......................#
#.......................#
#.......................#
#.P...##...###...##...E.#
########SSS###SSS########
#########################
