25 10
#########################
#.......................#
#.....................E.#
#....................####
#....................####
#....................####
#....................####
#....................####
#..P..w..............####
#########################
