200 10
########################################################################################################################################################################################################
#......................................................................................................................................................................................................#
#......................................................................................................................................................................................................#
#......................................................................................................................................................................................................#
#......................................................................................................................................................................................................#
#......................................................................................................................................................................................................#
#......................................................................................................................................................................................................#
#......................................................................................................................................................................................................#
#...P...............................................................................................................................................................................................E..#
########################################################################################################################################################################################################
