25 10
#########################
#.......................#
#.....................E.#
#....................####
#....................####
#....................####
#....................####
#............B.......####
#..P.p...B...B.......####
#########################
