######################################################################################################################################################################################################################################################
#                                                                                                                                                                                                                                                    #
#                                                                                                                                                                                                                                                    #
#                                                                                                                                                                                                                                                    #
#                                                                                                                                                                                                                                                    #
#                                                                                                                                                                                                                                                    #
#   P                                                                                                                                                                                                                                         E      #
######################################################################################################################################################################################################################################################
