#########################
#                       #
#                       #
#                     E #
#                    ####
#                    ####
#                    ####
#                    ####
#                    ####
#                    ####
#  P  w              ####
#########################
