##################################################################################
#                                                                                #
#                                                                                #
#                                                                                #
#                                                                                #
#   P                                                               E            #
##########################                                ########################
##########################                                ########################
##################################################
##################################################################################
