50 5
##################################################
#                                                #
#                                                #
#                                                #
#  p  y  SSSSSSSSSSSSSSSSSSSSSSSSSSSSSSSSSSS  E  #
##################################################
