#########################
#                       #
#                       #
#                       #
#                       #
#                       #
#                       #
#                       #
#                       #
#                       #
#  P                  E #
#########################
