82 25
0000000000000000000000000000000000000000000000000000000000000000000000000000000000
0                                                                                0
0                                                                                0
0              u          v            w          x           y         z        0
0         0000000000000000000000000000000000000000000000000000000000000000       0
0                                                                                0
0000                                                                          0000
0                                                                                0
0              p          q            r          s           t                  0
0         0000000000000000000000000000000000000000000000000000000000000000       0
0                                                                                0
0000                                                                          0000
0                                                                                0
0              k          l            m          n           o                  0
0         0000000000000000000000000000000000000000000000000000000000000000       0
0                                                                                0
0000                                                                          0000
0                                                                                0
0              f          g            h          i           j                  0
0         0000000000000000000000000000000000000000000000000000000000000000       0
0                                                                                0
0000                                                                          0000
0                                                                                0
0    1         a          b            c          d           e                3 0
0000000000000000000000000000000000000000000000000000000000000000000000000000000000
abcde
fghij
klmno
pqrst
uvwxyz