25 10
#########################
#                       #
#                       #
#                       #
#                       #
#                       #
#                       #
#                       #
# P        SSS        E #
#########################
