#########################
#                       #
#                       #
#                       #
#                       #
#                       #
#                       #
#                       #
#                       #
# P   ##   ###   ##   E #
########SSS###SSS########
#########################
