#########################
#                       #
#                       #
#                     E #
#                    ####
#                    ####
#                    ####
#                    ####
#                    ####
#            B       ####
#  P p   B   B       ####
#########################
