##################################################################################
#                                                                                #
#                                                                                #
#                                       ###                                      #
#                                       ###                                      #
#                                       ###                                      #
#                    #############      ###                                      #
#                    #############      ###                                      #
#   P             ################      ###                            E         #
##################################################################################
